WWWWWWWWWWWWWWW
WOOBBBBBBBBBOOW
WOWBWBWOWBWBWOW
WBBBOBBBBBBBOBW
WBWBWBWBWBWBWBW
WBOOBBOOOBBBOBW
WBWBWBWOWBWBWBW
WBBBBBOOOBBOBBW
WBWBWBWBWBWOWBW
WBBBOBBBBOBOOBW
WOWBWOWOWBWBWOW
WOOBBBBBBBBBOOW
WWWWWWWWWWWWWWW